111111111111111111111111000000000000000000000000000000000000000011111111111111111111111111111111111111111000111111111111111111111111111
111111111111111111111111011111111111111111111111100000001111111011111111111111111111111111111111111100101000101001111111111111110000000
000000000000000000011111000000000000000000000111111111111111111011111111111111111111111111111111111100111000111001111011111111111111111
111111100000000000000000000000000000011111111000000000001111111011111110000000000000000000000111111100101000101001111111111111110000000
000000001111111111111111111111110000100000000111111111111111111011111111111111111111111111111111111111111111111111111011111111111111111
111111100000000010111111100000111111100000000000000000001111111011111110000000000000000000000111111111100000001111111111111111110000000
000000000000000111111111100000110001100000000111111111111111111011111111111111111111111111111111111111111111111110000011111111111111111
111111100000000111111111100000110000100000000000000000001111111011111110000000000000000000000111111111111111111110000010111111110000000
000000000000000111111111111111111111100000000111111111111111111011111111111111111111111111111111111111111111111110000011111111111111111
111111100001111111111111111111110111111111000000000000001111111011111110000000000000000000000111111111111111111111111111111111110000000
000000000001111111111111111011111111011111000111111111111111111011111111111111111110000000000000000000000000000001110000011111111111111
111111101111100000111111111111111111111111111111000000001111111011111100000000000110000000111111110000001000000000000000000000000000000
000000000011110001111111111111101111111111111111111111111111111011111111111111111110000000111111110000001000000001110000011111101111111
111111101111110001111111111111111111111111010001000000001111111011111100000000000110000000111111110000001000000001111111111111100000000
000000000011110001111111111111111111111111000111111111111111111011111111111111111110001111111111110000001000000001011111111111101111111
111111101111110101111111000001011001111111000001000000001111111011111111111111111000001111111111111111111111110001110001111111100000000
000000000011111111111111000001111001111111000111111111111111111011111100000000011011111111111111110101010101110001100001111111101111111
111111101111111111111111000001111111111111000111110000001111111011111111111111111011101111101111111111111111111111100001111111100000000
000000000000000001111111111111111111111111010001011111111111111011111100000000000011111111111111111111001111111111000001111111101111111
111111100000000001111111111111101011111111111110001000001111111011111111111111111011111111111111111111111111111000011111111111100000000
000111100000000001111111000001111111111111111110001111111111111011111100000000000011111111111111110101010101111111111111111111101111111
000001100000000001111111000001101011111100001110001000001111111011111111111111111011111110001111111111111111111111110000011111100000000
000001100000000001111111000001111111111100001110001000000011111011111100000000000000000110001111110001111111111100000000011111101111111
111111101111111111111111111111101011111100001110001000000011111011111111111111111000000110001111110001010001111100000000011111100000000
111111101111111111111111111111111111111111111101111111111111111011100010011001100000000110001111111111111111111111111111111111101111111
111111101111101111111111111101111111111111110100011111111111111010100010011001100011111111111111111111111111011111111111111111100000000
111111101111111111111111111111111111111111111101111111111111111011100010011001100011111111111111111111111111111111111111111111101111111
111111101101111011111111111111101111001111111101111111111111111010100011111111111011111111111111111101111111111011111101111111100000000
111111101111111111111111111111111111111111111101111111111111111011101101111000011111111111111111111111111111111111111111111111101111111
000000001111001111111111111111111111111111111101111111111111111011111111111110001011111111111111111111111111111101110111111111100000000
011011111111001111111111111111111111111111111101111111111111111010101010000001110001000000001111111000000000111111111111111111101111111
011000000011001100011111111111111111110111111101111000001111111011111110000001110001000000001111111000000000111111111111111111101111111
000000000011001100011111100000000110001111001100001111111111111000000110000001110001000000001111111000000000000001000001111111101111111
011000000011001100011111100000000110000111001100001000001111111000000110000001110001000000001111111000000000000001000001111111111000111
000011001111111100011111100000000111111111111100001111111111111000000110000001110001000000001111111000000000000001000001111111100000001
011011111111010111111111100000000111111110110000001000001111111011111111110111111111111111111111111111111111111111111111111111100000001
000011111111111111011111100000000111111111110001111111111111111011111111110111111111111111111111111100111001111110011111111111110111111
011011111111111111011111111111111101111111110001111000001111111011111111110111111111111111111111111110111111111111110111111111110111111
000010000011111111111111111111111111111111110001111111111111111011111111110111111111111111111111111111111111111111111111111111110111111
011000000011111111111111100000000000000000000000000000111111111011111111110111011111011111111111111111110111110111111101111111110111111
000110000010001011111111101111111111111111111111111111111111111011111111110111111111111111111111111111111111111111111111111111110111111
011110111110001111111111100000000000000000000000000000111111111011111111110110111111111111111111111111111111111111111111111111100111111
000000001110001100011111101111111111111111111111111111111111111011111111111110111000000111111111110010010111111111110000011111100000000
011110111110001111111111100000000000000000000000000000111111111011111111100010111000000100100111110010011100000001110000011111101111111
000000001111111011011111101111111111111111111111111111111111111011111111100011111000000100100111111111111110001111110000011111100000000
011110000011111111111111100000000000000000000000000000111111111011111111100011111110011111111111111111100110001111111111111111101111111
000000000000000000111111101111111111111111111111111111111111111011111111100000100111111001001111111111111110001101011111111111100000000
011111111111111110111111100000000000000000000000000111111111111011111111110111111111111111111111111111110110001111111111111111101111111
000000000000000000111111101111111111111111111111111111111111111011111111110110111110111111111111110000011111111111110000011111100000000
011111111111111110111111100000000000000000000000001111111111111011111111110111111111111111111111110000011100111001110000011111101111111
000000000000000000111111101111111111111111111111111111111111111011111111110111111111111111111111110000011111111111110000011111100000000
011111111111111110111111100000000000000000000011111111111111111011111111110111111111111111111111111111111111111111111111111111101111111
000000000000000000111111101111111111111111111111111111111111111011111111110111111111111111111111111101111111111101111111011111100000000
011111111111111111111111101111111111111111111111111111111111111011111111110110000000010000000111111111111111111111111111111111101111111
011111111111111111111111101111111111111111111111111111111111111010000011111110000000010000000111111101110111111111111111101111100000000
011111111111111111111111101111111111111111111111111111111111111010000011000010000000010000000111111111111111111111111111111111101111111
011111111111111111111111101111111111111111111111111111111111111010000011000010000000010000000111111111111111111111111111110000000000000
011111111111111111111111101111111111111111111111111111111111111010000011000010000000010001111111111111100000000111111111110111111111111
011111111111111111111111111111111111111111111111111111111111111011111111111011111100010001111111111111100000000111110000110000000000000
011111111111111111111111111111111111111111111111111111111111111011111111111011111100011111111111111111100000000111110000110111111111111
011111111111111111111111111111111111111111111111111111111111111011111111111011111111111111111111111111100000000111110000110000000000000
011111111111111111111111111111111111111111111111111111111111111011111111111011111111111111111111111111100000000111111111110111111111111
011111111111111111111111111111111111111111111111111111111111111000000000000000000000000000000000000000000000000000000000000011111111111
011111111111111111111111111111111111111111111111111111111111111011111111011111111111111111111111111111111111111111111111111000000001111
011111111111111111111111111111111111111111111111111111111111111011111111010000000000000000000011100000000000000000000000000111111101111
011111111111111111111111111111111111111111111111111111111111111011111111011111111111111111111111111111111111111111111111111111111101111
011111111111111111111111111111111111111111111111111111111111111011111111011111111111111111111111111111111111111111111111111111111101111
011111111111111111111111111111111111111111111111111111111111111011111111011111111111111111111111111111111111111111111111111111111101111
000000000000000000000000000000000000000000000000000000000000000000001111000000000000000000000000000000000000000000000000000111111101111
011111111111111111111111111111111111111111111111111111111111111111101111111111111111111111111111111111111111111111111111110111111101111
000000000000000000001111111111111111111001111111111111111111111111100000000000000000000000000000000000000000000000000000000111100001111
011111111111111111111111111111111111111001111111111110001100111111111111111100111111111111111111111100011111111111111111111111111101111
000000000000000000001111000000011111111111111111111110001100111111111111111100111111111111110011111111111100111111110000000111100001111
011111111111111111111111000000011111111111111111111110001111111110001111111111111111111000111111111111110001111111110000000111111101111
000000000000000000001111000000011110001110001001111110001111111110001110011111100110011000110011100111110001100100110000000111100001111
011111111111111111111111000000011110001110001001111111111111101010001110010111100110011000110011100111110001100100110000000111111101111
000000000000000000001111111111111111111111111111111111111111111111111111111111111111111111111111111111111111111111111111111111100001111
011111111111111111111111111111111111111111111111111111111111111111111111111111111111111111111111111111111111111111111111111111111001111
000000000000000000001111111111111111111111111111111111111111111111111111111111111111111111111111111111111111111111111111111111100011111
011111111111111111111111111111111111111111111111111111111111111111111111111111111111111111111111111111111111111111111111111111111011111
000000000000000000000000000000000000000000000000011100000000000000000000000000000000000000000000000000000000000000000000000000000011111
011111111111111111111111111111111111111111111111111111111111111111111111111111111111111111111111111111111111111111111111111111111011111
000000000000000000000000000000000000000000000000011100000000000000000000000000000000000000000000000000000000000000000000000000000011111
000000000000000000000000000000000000000000000000000000000000000000000000000000000000000000000000000000000000000000000000000000000011111
111111111111111111111111111111111111111111111111111111111111111111111111111111111111111111111111111111111111111111111111111111111111111
